year	cited_by_article	count	in_deg_in_context	in_deg_in_context_tapered	in_deg_out_context	in_deg_out_context_tapered	in_deg_total	in_deg_total_tapered
1903	0	1	1	0.00884955752212	7	0.0619469026549	8	0.070796460177
1904	0	1	3	0.0267857142857	658	5.875	661	5.90178571429
1906	0	1	2	0.0181818181818	36	0.327272727273	38	0.345454545455
1907	0	1	4	0.0366972477064	57	0.522935779817	61	0.559633027523
1909	0	3	3	0.0280373831776	84	0.785046728972	87	0.81308411215
1910	0	5	8	0.0754716981132	171	1.61320754717	179	1.68867924528
1911	0	1	1	0.00952380952381	234	2.22857142857	235	2.23809523809
1913	0	1	1	0.00970873786408	8	0.0776699029126	9	0.0873786407767
1914	0	1	3	0.0294117647059	1	0.00980392156863	4	0.0392156862745
1915	0	1	4	0.039603960396	59	0.584158415842	63	0.623762376238
1918	0	1	1	0.0102040816327	0	0.0	1	0.0102040816327
1922	0	2	2	0.0212765957446	31	0.329787234043	33	0.351063829787
1923	0	1	2	0.0215053763441	457	4.91397849462	459	4.93548387096
1924	0	2	2	0.0217391304348	7	0.0760869565218	9	0.0978260869566
1926	0	4	4	0.0444444444444	172	1.91111111111	176	1.95555555555
1927	0	1	1	0.0112359550562	35	0.393258426966	36	0.404494382022
1928	0	1	1	0.0113636363636	2	0.0227272727273	3	0.0340909090909
1930	0	3	3	0.0348837209301	25	0.290697674419	28	0.325581395349
1931	0	1	3	0.0352941176471	5	0.0588235294118	8	0.0941176470589
1932	0	2	5	0.0595238095238	23	0.27380952381	28	0.333333333333
1933	0	3	3	0.0361445783133	11	0.132530120482	14	0.168674698796
1934	0	1	1	0.0121951219512	3	0.0365853658537	4	0.0487804878049
1935	0	1	5	0.0617283950617	3570	44.0740740741	3575	44.1358024692
1936	0	2	2	0.025	23	0.2875	25	0.3125
1937	0	2	3	0.0379746835443	15	0.189873417722	18	0.227848101266
1938	0	3	4	0.051282051282	154	1.97435897436	158	2.02564102564
1939	0	1	1	0.012987012987	5	0.0649350649351	6	0.0779220779221
1940	0	3	4	0.0526315789473	75	0.986842105263	79	1.03947368421
1941	0	1	1	0.0133333333333	36	0.48	37	0.493333333333
1942	0	1	1	0.0135135135135	19	0.256756756757	20	0.27027027027
1943	0	1	1	0.013698630137	315	4.31506849315	316	4.32876712329
1944	0	2	25	0.347222222222	674	9.36111111111	699	9.70833333333
1947	0	6	6	0.0869565217392	124	1.79710144928	130	1.88405797102
1948	0	5	15	0.220588235294	5467	80.3970588236	5482	80.6176470589
1949	0	4	5	0.0746268656716	240	3.58208955224	245	3.65671641791
1950	0	5	6	0.090909090909	735	11.1363636364	741	11.2272727273
1951	0	3	5	0.076923076923	523	8.04615384616	528	8.12307692308
1952	0	5	5	0.078125	102	1.59375	107	1.671875
1953	0	5	5	0.079365079365	370	5.87301587302	375	5.95238095238
1954	0	3	10	0.16129032258	636	10.2580645161	646	10.4193548387
1955	0	3	3	0.049180327869	411	6.73770491803	414	6.7868852459
1961	0	1	1	0.0181818181818	46	0.836363636364	47	0.854545454546
1967	0	2	3	0.0612244897959	1172	23.918367347	1175	23.9795918368
1968	0	2	2	0.0416666666666	244	5.08333333333	246	5.125
1970	0	2	2	0.0434782608696	476	10.347826087	478	10.3913043478
1971	0	2	51	1.13333333333	8181	181.8	8232	182.933333333
1972	0	1	1	0.0227272727273	142	3.22727272727	143	3.25
1973	0	3	4	0.093023255814	184	4.27906976744	188	4.37209302325
1974	0	4	10	0.238095238096	2113	50.3095238096	2123	50.5476190477
1975	0	5	6	0.146341463414	388	9.46341463415	394	9.60975609756
1976	0	1	1	0.025	50	1.25	51	1.275
1977	0	3	5	0.128205128205	249	6.38461538462	254	6.51282051282
1978	0	9	43	1.13157894737	1602	42.1578947368	1645	43.2894736842
1979	0	4	5	0.135135135135	3560	96.2162162162	3565	96.3513513513
1980	0	3	3	0.0833333333334	180	4.99999999999	183	5.08333333333
1981	0	2	3	0.0857142857143	142	4.05714285714	145	4.14285714285
1982	0	7	26	0.764705882353	1405	41.3235294117	1431	42.0882352941
1983	0	5	5	0.151515151515	548	16.6060606061	553	16.7575757576
1984	0	8	14	0.4375	1464	45.75	1478	46.1875
1985	0	8	14	0.451612903226	1678	54.1290322581	1692	54.5806451613
1986	0	8	14	0.466666666667	490	16.3333333333	504	16.8
1987	0	11	19	0.655172413793	4422	152.482758621	4441	153.137931035
1988	1	14	69	2.46428571429	3098	110.642857143	3167	113.107142857
1989	0	15	47	1.74074074074	2464	91.2592592593	2511	93.0
1990	0	87	183	7.03846153846	13381	514.653846154	13564	521.692307692
1991	0	953	2301	92.04	145275	5811.0	147576	5903.04
1992	0	989	2573	107.208333333	152787	6366.125	155360	6473.33333333
1993	1	1033	2548	110.782608696	179393	7799.69565217	181941	7910.47826087
1994	1	1084	2812	127.818181818	139686	6349.36363636	142498	6477.18181818
1995	1	1182	3008	143.238095238	182886	8708.85714286	185894	8852.0952381
1996	0	1265	3232	161.6	179203	8960.15	182435	9121.75
1997	1	1392	3326	175.052631579	171876	9046.10526316	175202	9221.15789474
1998	0	1281	3035	168.611111111	160132	8896.22222222	163167	9064.83333333
1999	2	1330	3335	196.176470588	159182	9363.64705882	162517	9559.82352941
2000	1	1233	2851	178.1875	154236	9639.75	157087	9817.9375
2001	2	1126	2637	175.8	134787	8985.8	137424	9161.6
2002	3	928	1921	137.214285714	90480	6462.85714286	92401	6600.07142857
2003	3	829	1557	119.769230769	63059	4850.69230769	64616	4970.46153846
2004	7	615	1111	92.5833333333	42609	3550.75	43720	3643.33333333
2005	4	588	989	89.9090909091	33653	3059.36363636	34642	3149.27272727
2006	9	343	477	47.7	17062	1706.2	17539	1753.9
2007	6	160	216	24.0	3829	425.444444444	4045	449.444444444
2008	3	136	115	14.375	1022	127.75	1137	142.125
2009	1	119	22	3.14285714285	146	20.8571428571	168	24.0
2010	1	1	1	0.166666666667	0	0.0	1	0.166666666667
